[
  [
    ["^", "ˇ", "↻", "˙", "˞", "̣"],
    ["1", "°", "¹", "ª", "₁", "¬"],
    ["2", "§", "²", "º", "₂", "∨"],
    ["3", "ℓ", "³", "№", "₃", "∧"],
    ["4", "»", "›", "", "♀", "⊥"],
    ["5", "«", "‹", "·", "♂", "∡"],
    ["6", "$", "¢", "£", "⚥", "∥"],
    ["7", "€", "¥", "¤", "ϰ", "→"],
    ["8", "„", "‚", "⇥", "⟨", "∞"],
    ["9", "“", "‘", " /", "⟩", "∝"],
    ["0", "”", "’", "*", "₀", "∅"],
    ["-", "—", "-", "‑", "­"],
    ["`", "¸", "°", "¨", "", "¯"],
    ["←"]
  ],
  [
    ["⇥"],
    ["l", "L", "…", "⇞", "ξ", "Ξ"],
    ["v", "V", "_", "⌫", "", "√"],
    ["x", "X", "[", "⇡", "λ", "Λ"],
    ["c", "C", "]", "Entf", "χ", "ℂ"],
    ["w", "W", "^", "⇟", "ω", "Ω"],
    ["k", "K", "!", "¡", "κ", "×"],
    ["h", "H", "<", "7", "ψ", "Ψ"],
    ["g", "G", ">", "8", "γ", "Γ"],
    ["f", "F", "=", "9", "φ", "Φ"],
    ["q", "Q", "&", "+", "ϕ", "ℚ"],
    ["y", "Y", "@", ".", "υ", "∇"],
    ["ß", "ẞ", "ſ", "−", "ς", "∘"],
    []
  ],
  [
    ["⇩"],
    ["u", "U", "\\", "⇱", "", "⊂"],
    ["i", "I", "/", "⇠", "ι", "∫"],
    ["a", "A", "{",  "⇣", "α", "∀"],
    ["e", "E", "}", "⇢", "ε", "∃"],
    ["o", "O", "*", "⇲", "ο", "∈"],
    ["s", "S", "?", "¿", "σ", "Σ"],
    ["n", "N", "[", "4", "ν", "ℕ"],
    ["r", "R", "]", "5", "ρ", "ℝ"],
    ["t", "T", "-", "6", "τ", "∂"],
    ["d", "D", ":", ",", "δ", "Δ"],
    ["⇘"],
    ["´", "~", "/", "˝", "", "˘"],
    ["\n"]
  ],
  [
    ["⇧"],
    ["⇚"],
    ["ü", "Ü", "#", "\u001B", "", "∪"],
    ["ö", "Ö", "$", "", "ϵ", "∩"],
    ["ä", "Ä", "|", "⎀", "η", "ℵ"],
    ["p", "P", "~", "\n", "π", "Π"],
    ["z", "Z", "`", "↶", "ζ", "ℤ"],
    ["b", "B", "+", ":", "β", "⇐"],
    ["m", "M", "%", "1", "μ", "⇔"],
    [",", "–", "\"", "2", "ϱ", "⇒"],
    [".", "•", "'", "3", "ϑ", "↦"],
    ["j", "J", ";", ";", "θ", "Θ"],
    ["⇗"]
  ],       
  [
    ["♕"],
    [],
    ["♔"],
    [" ", " ", " ", "0", " ", " "],
    ["⇙"],
    [],
    [],
    ["♛"]
  ]
]